###################
#...M.............#
#......###.....##.#
#........M........#
#.##......#...##..#
#.................#
#....##..M...##...#
#.................#
#..##......##...###
#.......M.........#
#........##.......#
#....##...........#
#.................#
###################