###################
#.................#
#......###.....##.#
#.................#
#.##......#...##..#
#.................#
#....##......##...#
#.................#
#..##......##...###
#.................#
#........##.......#
#....##...........#
#.................#
###################
